NO ./fake_path_n
SO ./fake_path_s
WE ./fake_path_w
EA ./fake_path_e

F 220,100,0
C 225,30,0

111111111
1000000011111
11110000E0001
1011111111111
1111111111111