SO ./textures/wall2.xpm
WE ./textures/door.xpm
EA ./textures/darkening.xpm
NO ./textures/wall.xpm

F 100,20,70
C 0,0,0

1111111111111111111
1000000010111111111
1110011111111111111
1000000000011111111
10000000E0000111111
1000000000000111111
1111111000000111111
1111111000000111111
1111110000011111111
1000000000000000001
1100000000000000111
1111000000000001111
1111111111111111111